8
6
111111
155051
154001
110401
114011
134017
110017
711117