8
7
1111111
1000001
1054501
1045401
1354501
1045401
1000001
1111111
