8
8
77111117
11100017
10401011
10100501
10000101
11010001
71300111
71111177
