8
6
111111
150051
154001
110401
110011
134017
110017
711117